//MAP CONVERTED BY dmm2tgm.py THIS HEADER COMMENT PREVENTS RECONVERSION, DO NOT REMOVE
"a" = (
/turf/simulated/floor/tiled,
/area/deepmaint)
"b" = (
/turf/simulated/floor/tiled/dark/panels,
/area/deepmaint)
"c" = (
/obj/machinery/power/nt_obelisk,
/turf/simulated/floor/carpet/bcarpet,
/area/deepmaint)
"d" = (
/turf/simulated/floor/carpet/bcarpet,
/area/deepmaint)
"e" = (
/obj/item/remains,
/turf/simulated/floor/carpet/bcarpet,
/area/deepmaint)
"f" = (
/obj/structure/table/woodentable,
/obj/item/weapon/gun/projectile/revolver/deckard,
/turf/simulated/floor/carpet/bcarpet,
/area/deepmaint)
"g" = (
/obj/structure/table/woodentable,
/obj/item/weapon/book/ritual/cruciform{
	desc = "Contains holy litany and religious prayers. This one has the phrase 'THE SKIES ARE BURIED DEEP' scrawled all over it...";
	name = "Defaced Mekhane book"
	},
/turf/simulated/floor/carpet/bcarpet,
/area/deepmaint)
"h" = (
/obj/structure/table/woodentable,
/obj/random/pack/cloth/low_chance,
/turf/simulated/floor/carpet/bcarpet,
/area/deepmaint)
"i" = (
/obj/structure/bed/chair/wood{
	tag = "icon-wooden_chair (NORTH)";
	icon_state = "wooden_chair";
	dir = 1
	},
/turf/simulated/floor/tiled/dark/panels,
/area/deepmaint)
"j" = (
/turf/simulated/floor/tiled/dark/golden,
/area/deepmaint)
"k" = (
/obj/structure/bed/chair/wood{
	tag = "icon-wooden_chair (NORTH)";
	icon_state = "wooden_chair";
	dir = 1
	},
/obj/item/remains,
/turf/simulated/floor/tiled/dark/panels,
/area/deepmaint)
"l" = (
/obj/random/powercell,
/turf/simulated/floor/tiled/dark/golden,
/area/deepmaint)
"m" = (
/obj/random/powercell/low_chance,
/turf/simulated/floor/tiled/dark/golden,
/area/deepmaint)
"n" = (
/obj/machinery/vending/theomat,
/turf/simulated/floor/tiled/dark/panels,
/area/deepmaint)

(1,1,1) = {"
a
a
a
a
a
a
a
a
a
a
a
"}
(2,1,1) = {"
a
b
b
b
b
b
b
b
b
n
a
"}
(3,1,1) = {"
a
b
c
d
d
i
l
i
j
b
a
"}
(4,1,1) = {"
a
b
d
d
d
i
j
k
j
b
a
"}
(5,1,1) = {"
a
b
d
f
d
i
j
i
j
b
a
"}
(6,1,1) = {"
a
b
e
g
d
j
j
j
j
j
a
"}
(7,1,1) = {"
a
b
d
h
d
k
j
i
j
b
a
"}
(8,1,1) = {"
a
b
d
d
d
i
m
i
j
b
a
"}
(9,1,1) = {"
a
b
c
d
d
i
j
k
j
b
a
"}
(10,1,1) = {"
a
b
b
b
b
b
b
b
b
b
a
"}
(11,1,1) = {"
a
a
a
a
a
a
a
a
a
a
a
"}
