//MAP CONVERTED BY dmm2tgm.py THIS HEADER COMMENT PREVENTS RECONVERSION, DO NOT REMOVE
"a" = (
/turf/simulated/floor/tiled/techmaint_panels,
/area/deepmaint)
"b" = (
/turf/simulated/floor/tiled/techmaint,
/area/deepmaint)
"c" = (
/turf/simulated/floor/tiled/techmaint_perforated,
/area/deepmaint)
"d" = (
/obj/item/inflatable/door/torn,
/turf/simulated/floor/tiled/techmaint_panels,
/area/deepmaint)
"e" = (
/turf/simulated/wall/r_wall,
/area/deepmaint)
"f" = (
/turf/simulated/floor/tiled/techmaint_cargo,
/area/deepmaint)
"g" = (
/obj/structure/inflatable/door,
/turf/simulated/floor/tiled/techmaint_perforated,
/area/deepmaint)
"h" = (
/obj/structure/table/standard,
/obj/random/boxes/low_chance,
/turf/simulated/floor/tiled/techmaint_panels,
/area/deepmaint)
"i" = (
/obj/item/remains/human,
/obj/random/rations,
/obj/random/rig/damaged,
/turf/simulated/floor/reinforced,
/area/deepmaint)
"j" = (
/obj/random/pouch,
/turf/simulated/floor/reinforced,
/area/deepmaint)
"k" = (
/turf/simulated/floor/reinforced,
/area/deepmaint)
"l" = (
/turf/simulated/floor/reinforced/phoron,
/area/deepmaint)
"m" = (
/obj/random/tank,
/obj/item/remains/human,
/obj/random/contraband/low_chance,
/turf/simulated/floor/tiled/techmaint_panels,
/area/deepmaint)
"n" = (
/obj/structure/inflatable/wall,
/turf/simulated/floor/tiled/techmaint_perforated,
/area/deepmaint)
"o" = (
/obj/structure/table/standard,
/obj/random/toolbox,
/obj/random/techpart,
/turf/simulated/floor/tiled/techmaint_panels,
/area/deepmaint)
"p" = (
/obj/random/soda/low_chance,
/turf/simulated/floor/reinforced,
/area/deepmaint)
"q" = (
/obj/structure/inflatable/door,
/turf/simulated/floor/tiled/techmaint_panels,
/area/deepmaint)
"r" = (
/obj/item/weapon/inflatable_dispenser,
/turf/simulated/floor/tiled/techmaint_panels,
/area/deepmaint)
"s" = (
/obj/structure/table/rack/shelf,
/obj/random/lathe_disk,
/obj/random/lathe_disk/advanced/low_chance,
/obj/random/lathe_disk/low_chance,
/obj/random/lathe_disk/low_chance,
/turf/simulated/floor/tiled/techmaint_panels,
/area/deepmaint)
"t" = (
/obj/machinery/air_sensor,
/turf/simulated/floor/reinforced,
/area/deepmaint)
"u" = (
/obj/item/weapon/storage/box/matches,
/turf/simulated/floor/reinforced,
/area/deepmaint)
"v" = (
/obj/structure/sign/signnew/danger,
/turf/simulated/wall/r_wall,
/area/deepmaint)
"w" = (
/obj/structure/sign/signnew/oxidants,
/turf/simulated/wall/r_wall,
/area/deepmaint)
"x" = (
/obj/effect/window_lwall_spawn/smartspawnphoron,
/turf/simulated/floor/tiled/techmaint,
/area/deepmaint)
"y" = (
/obj/effect/floor_decal/industrial/warning{
	icon_state = "warning";
	dir = 1
	},
/obj/structure/closet/crate/internals,
/turf/simulated/floor/tiled/techmaint,
/area/deepmaint)
"z" = (
/obj/effect/decal/cleanable/roach_egg_remains,
/obj/effect/floor_decal/industrial/warning{
	icon_state = "warning";
	dir = 1
	},
/turf/simulated/floor/tiled/techmaint,
/area/deepmaint)
"A" = (
/obj/random/mob/roaches/low_chance,
/turf/simulated/floor/tiled/techmaint_panels,
/area/deepmaint)
"B" = (
/obj/item/modular_computer/console/preset/engineering/atmos,
/obj/effect/floor_decal/industrial/warning{
	icon_state = "warning";
	dir = 1
	},
/turf/simulated/floor/tiled/techmaint,
/area/deepmaint)
"C" = (
/obj/effect/floor_decal/industrial/warning{
	icon_state = "warning";
	dir = 1
	},
/turf/simulated/floor/tiled/techmaint,
/area/deepmaint)
"D" = (
/obj/effect/floor_decal/industrial/warning{
	icon_state = "warning";
	dir = 1
	},
/turf/simulated/floor/tiled/techmaint_cargo,
/area/deepmaint)
"E" = (
/obj/structure/table/standard,
/obj/random/booze,
/turf/simulated/floor/tiled/techmaint_panels,
/area/deepmaint)

(1,1,1) = {"
c
c
c
c
c
c
c
c
c
c
c
"}
(2,1,1) = {"
c
a
e
h
o
s
e
a
A
a
c
"}
(3,1,1) = {"
c
a
e
e
e
e
v
y
b
a
c
"}
(4,1,1) = {"
c
a
e
i
p
k
x
z
b
a
c
"}
(5,1,1) = {"
c
a
e
j
k
k
x
B
b
a
c
"}
(6,1,1) = {"
c
a
e
k
k
t
x
C
b
a
c
"}
(7,1,1) = {"
c
a
e
k
k
k
x
C
b
a
c
"}
(8,1,1) = {"
c
a
e
l
k
u
x
D
b
a
c
"}
(9,1,1) = {"
c
a
e
e
q
e
w
D
f
a
c
"}
(10,1,1) = {"
c
d
e
m
r
E
e
A
a
a
c
"}
(11,1,1) = {"
c
c
g
g
n
n
n
c
c
c
c
"}
