//MAP CONVERTED BY dmm2tgm.py THIS HEADER COMMENT PREVENTS RECONVERSION, DO NOT REMOVE
"a" = (
/turf/simulated/floor/tiled/dark/gray_perforated,
/area/deepmaint)
"b" = (
/obj/machinery/light/small,
/turf/simulated/floor/tiled/dark/gray_perforated,
/area/deepmaint)
"c" = (
/turf/simulated/wall,
/area/deepmaint)
"d" = (
/obj/machinery/door/airlock/maintenance_common,
/turf/simulated/floor/tiled/techmaint,
/area/deepmaint)
"e" = (
/obj/effect/decal/cleanable/dirt,
/turf/simulated/floor/tiled/dark/gray_perforated,
/area/deepmaint)
"f" = (
/obj/effect/window_lwall_spawn,
/turf/simulated/floor/tiled/techmaint,
/area/deepmaint)
"g" = (
/obj/random/traps/low_chance,
/obj/random/junk/low_chance,
/obj/random/scrap/sparse_weighted/low_chance,
/turf/simulated/floor/tiled/techmaint,
/area/deepmaint)
"h" = (
/obj/random/traps,
/obj/random/junk/low_chance,
/obj/effect/decal/cleanable/dirt,
/obj/effect/decal/cleanable/dirt,
/turf/simulated/floor/tiled/techmaint,
/area/deepmaint)
"i" = (
/obj/random/traps/low_chance,
/obj/random/junk/low_chance,
/obj/random/scrap/sparse_weighted/low_chance,
/obj/effect/decal/cleanable/dirt,
/obj/effect/decal/cleanable/dirt,
/turf/simulated/floor/tiled/techmaint,
/area/deepmaint)
"j" = (
/obj/random/traps/low_chance,
/obj/random/junk/low_chance,
/obj/random/scrap/sparse_weighted/low_chance,
/obj/machinery/light/small{
	dir = 4;
	pixel_y = 0
	},
/turf/simulated/floor/tiled/techmaint,
/area/deepmaint)
"k" = (
/obj/random/traps/low_chance,
/obj/random/junk/low_chance,
/obj/random/scrap/sparse_weighted/low_chance,
/obj/effect/decal/cleanable/dirt,
/turf/simulated/floor/tiled/techmaint,
/area/deepmaint)
"l" = (
/obj/random/traps/low_chance,
/obj/random/junk/low_chance,
/obj/random/scrap/sparse_weighted/low_chance,
/obj/machinery/light{
	dir = 4;
	icon_state = "tube1"
	},
/turf/simulated/floor/tiled/techmaint,
/area/deepmaint)
"m" = (
/obj/random/traps/low_chance,
/obj/random/junk/low_chance,
/obj/random/junk/low_chance,
/obj/random/scrap/sparse_weighted/low_chance,
/obj/effect/decal/cleanable/dirt,
/turf/simulated/floor/tiled/techmaint,
/area/deepmaint)
"n" = (
/obj/random/junk/low_chance,
/turf/simulated/floor/tiled/dark/gray_perforated,
/area/deepmaint)
"o" = (
/obj/random/traps/low_chance,
/obj/random/junk/low_chance,
/obj/random/scrap/sparse_weighted/low_chance,
/obj/random/junk/low_chance,
/turf/simulated/floor/tiled/techmaint,
/area/deepmaint)
"p" = (
/obj/random/traps/low_chance,
/obj/random/junk/low_chance,
/obj/random/scrap/sparse_weighted/low_chance,
/obj/effect/decal/cleanable/dirt,
/obj/random/junk/low_chance,
/turf/simulated/floor/tiled/techmaint,
/area/deepmaint)
"q" = (
/obj/random/traps/low_chance,
/turf/simulated/floor/tiled/dark/gray_perforated,
/area/deepmaint)
"r" = (
/obj/random/traps,
/obj/random/junk/low_chance,
/obj/random/scrap/sparse_weighted/low_chance,
/obj/effect/decal/cleanable/dirt,
/turf/simulated/floor/tiled/techmaint,
/area/deepmaint)
"s" = (
/obj/effect/decal/cleanable/dirt,
/obj/random/traps/low_chance,
/turf/simulated/floor/tiled/techmaint,
/area/deepmaint)
"t" = (
/obj/random/traps/low_chance,
/obj/random/scrap/sparse_weighted/low_chance,
/obj/effect/decal/cleanable/dirt,
/turf/simulated/floor/tiled/techmaint,
/area/deepmaint)
"u" = (
/obj/random/traps/low_chance,
/obj/effect/decal/cleanable/dirt,
/turf/simulated/floor/tiled/dark/gray_perforated,
/area/deepmaint)
"v" = (
/obj/random/traps/low_chance,
/obj/random/junk/low_chance,
/obj/machinery/door/airlock/maintenance_common,
/turf/simulated/floor/tiled/techmaint,
/area/deepmaint)
"w" = (
/obj/random/traps,
/obj/random/junk/low_chance,
/obj/machinery/door/airlock/maintenance_common,
/turf/simulated/floor/tiled/techmaint,
/area/deepmaint)
"x" = (
/obj/machinery/door/airlock/maintenance_common,
/obj/random/traps,
/obj/random/junk/low_chance,
/obj/effect/decal/cleanable/dirt,
/turf/simulated/floor/light,
/area/deepmaint)
"y" = (
/obj/effect/decal/cleanable/dirt,
/turf/simulated/floor/tiled/techmaint,
/area/deepmaint)
"z" = (
/obj/random/traps/low_chance,
/obj/effect/decal/cleanable/dirt,
/obj/effect/decal/cleanable/dirt,
/turf/simulated/floor/tiled/techmaint,
/area/deepmaint)
"A" = (
/obj/random/traps,
/obj/random/traps/low_chance,
/turf/simulated/floor/tiled/dark/gray_perforated,
/area/deepmaint)

(1,1,1) = {"
a
e
a
a
n
e
a
e
a
n
a
"}
(2,1,1) = {"
a
c
f
c
c
c
c
c
c
c
e
"}
(3,1,1) = {"
e
c
i
j
k
k
g
k
k
x
a
"}
(4,1,1) = {"
a
c
k
c
i
g
k
k
r
x
e
"}
(5,1,1) = {"
a
c
i
c
w
c
c
c
f
c
a
"}
(6,1,1) = {"
a
d
k
c
g
k
g
c
s
s
a
"}
(7,1,1) = {"
b
c
m
v
k
o
p
c
t
y
q
"}
(8,1,1) = {"
e
c
i
c
k
o
o
c
t
z
a
"}
(9,1,1) = {"
a
h
k
f
l
g
g
c
u
q
q
"}
(10,1,1) = {"
a
c
c
c
c
c
c
c
u
q
a
"}
(11,1,1) = {"
a
a
n
a
a
a
a
a
u
a
A
"}
