"a" = (/turf/simulated/floor/tiled/dark/gray_perforated,/area/deepmaint)
"b" = (/obj/machinery/light/small,/turf/simulated/floor/tiled/dark/gray_perforated,/area/deepmaint)
"c" = (/turf/simulated/wall,/area/deepmaint)
"d" = (/obj/machinery/door/airlock/maintenance_common,/turf/simulated/floor/tiled/techmaint,/area/deepmaint)
"e" = (/obj/random/traps,/obj/random/junk/low_chance,/turf/simulated/floor/tiled/techmaint,/area/deepmaint)
"f" = (/obj/effect/window_lwall_spawn,/turf/simulated/floor/tiled/techmaint,/area/deepmaint)
"g" = (/obj/random/traps/low_chance,/obj/random/junk/low_chance,/obj/random/scrap/sparse_weighted/low_chance,/turf/simulated/floor/tiled/techmaint,/area/deepmaint)
"h" = (/obj/random/traps/low_chance,/obj/random/junk/low_chance,/obj/random/junk/low_chance,/obj/random/scrap/sparse_weighted/low_chance,/turf/simulated/floor/tiled/techmaint,/area/deepmaint)
"i" = (/turf/simulated/floor/tiled/techmaint_panels,/area/deepmaint)
"j" = (/obj/random/traps/low_chance,/obj/random/junk/low_chance,/obj/random/scrap/sparse_weighted/low_chance,/obj/machinery/light/small{dir = 4; pixel_y = 0},/turf/simulated/floor/tiled/techmaint,/area/deepmaint)
"k" = (/obj/random/traps,/obj/random/junk/low_chance,/obj/random/scrap/sparse_weighted/low_chance,/turf/simulated/floor/tiled/techmaint,/area/deepmaint)
"l" = (/obj/random/traps/low_chance,/obj/random/junk/low_chance,/obj/random/scrap/sparse_weighted/low_chance,/obj/machinery/light{dir = 4; icon_state = "tube1"},/turf/simulated/floor/tiled/techmaint,/area/deepmaint)
"m" = (/turf/simulated/floor/light,/area/deepmaint)
"n" = (/obj/random/traps/low_chance,/obj/random/junk/low_chance,/obj/random/scrap/sparse_weighted/low_chance,/turf/simulated/floor/tiled/dark/gray_perforated,/area/deepmaint)
"o" = (/turf/simulated/floor/tiled/techmaint,/area/deepmaint)
"p" = (/obj/random/traps/low_chance,/obj/random/scrap/sparse_weighted/low_chance,/turf/simulated/floor/tiled/techmaint,/area/deepmaint)
"q" = (/obj/random/traps/low_chance,/turf/simulated/floor/tiled/dark/gray_perforated,/area/deepmaint)
"r" = (/obj/machinery/door/airlock/maintenance_common,/obj/random/traps,/obj/random/junk/low_chance,/turf/simulated/floor/light,/area/deepmaint)
"s" = (/obj/random/traps/low_chance,/turf/simulated/floor/tiled/techmaint,/area/deepmaint)
"t" = (/obj/random/traps/low_chance,/turf/simulated/floor/light,/area/deepmaint)
"u" = (/obj/random/traps,/obj/random/traps/low_chance,/turf/simulated/floor/light,/area/deepmaint)
"v" = (/obj/random/traps/low_chance,/obj/random/junk/low_chance,/obj/machinery/door/airlock/maintenance_common,/turf/simulated/floor/tiled/techmaint,/area/deepmaint)
"w" = (/obj/random/traps,/obj/random/junk/low_chance,/obj/machinery/door/airlock/maintenance_common,/turf/simulated/floor/tiled/techmaint,/area/deepmaint)

(1,1,1) = {"
aaaaaabaaaa
accccdcceca
afgggghggca
icjcccvcfca
icggwggglca
mcggcgggnca
mcggcgggnca
mcggcccccca
mcgkfoppqqq
mcrrcoosqqa
mmmmmmtmtmu
"}
