//MAP CONVERTED BY dmm2tgm.py THIS HEADER COMMENT PREVENTS RECONVERSION, DO NOT REMOVE
"a" = (
/turf/unsimulated/wall,
/area/crawler)
"b" = (
/turf/simulated/floor/tiled/derelict,
/area/crawler)
"c" = (
/turf/simulated/wall/untinted/onestar_reinforced,
/area/crawler)
"d" = (
/obj/machinery/door/airlock/gold,
/turf/simulated/floor/tiled/derelict,
/area/crawler)
"e" = (
/obj/crawler/bossfight_arena,
/turf/simulated/floor/tiled/derelict,
/area/crawler)
"f" = (
/obj/structure/bed/chair/custom/onestar{
	icon_state = "onestar_chair_grey";
	dir = 4
	},
/turf/simulated/floor/tiled/derelict,
/area/crawler)
"g" = (
/obj/structure/table/onestar,
/obj/spawner/pack/tech_loot/onestar,
/turf/simulated/floor/tiled/derelict,
/area/crawler)
"h" = (
/obj/structure/bed/chair/custom/onestar{
	icon_state = "onestar_chair_grey";
	dir = 8
	},
/turf/simulated/floor/tiled/derelict,
/area/crawler)
"i" = (
/obj/structure/bed/chair/custom/onestar/red,
/turf/simulated/floor/tiled/derelict,
/area/crawler)
"j" = (
/obj/structure/closet/onestar/tier3,
/turf/simulated/floor/tiled/derelict,
/area/crawler)
"k" = (
/obj/structure/table/onestar,
/obj/spawner/tool/advanced/onestar,
/turf/simulated/floor/tiled/derelict,
/area/crawler)
"l" = (
/obj/structure/table/onestar,
/obj/spawner/firstaid,
/turf/simulated/floor/tiled/derelict,
/area/crawler)
"m" = (
/obj/item/storage/firstaid/adv,
/obj/structure/table/rack/shelf,
/obj/item/storage/firstaid/adv,
/turf/simulated/floor/tiled/derelict,
/area/crawler)
"n" = (
/obj/item/storage/firstaid/toxin,
/obj/structure/table/rack/shelf,
/obj/item/storage/firstaid/toxin,
/turf/simulated/floor/tiled/derelict,
/area/crawler)
"o" = (
/obj/item/storage/firstaid/surgery,
/obj/structure/table/rack/shelf,
/turf/simulated/floor/tiled/derelict,
/area/crawler)
"q" = (
/obj/machinery/optable,
/turf/simulated/floor/tiled/derelict,
/area/crawler)
"r" = (
/mob/living/simple_animal/hostile/megafauna/one_star,
/turf/simulated/floor/tiled/derelict,
/area/crawler)
"s" = (
/obj/structure/table/rack/shelf,
/obj/spawner/pack/tech_loot/onestar,
/obj/spawner/pack/tech_loot/low_chance,
/obj/spawner/tool/advanced/onestar/low_chance,
/turf/simulated/floor/tiled/derelict,
/area/crawler)
"t" = (
/mob/living/exosuit/premade/heavy,
/turf/simulated/floor/tiled/derelict,
/area/crawler)
"u" = (
/mob/living/exosuit/premade/combat/slayer,
/turf/simulated/floor/tiled/derelict,
/area/crawler)
"v" = (
/mob/living/exosuit/premade/powerloader/firefighter,
/turf/simulated/floor/tiled/derelict,
/area/crawler)
"w" = (
/mob/living/exosuit/premade/random/extra,
/turf/simulated/floor/tiled/derelict,
/area/crawler)
"x" = (
/obj/structure/table/onestar,
/obj/item/storage/firstaid/surgery,
/turf/simulated/floor/tiled/derelict,
/area/crawler)
"y" = (
/obj/structure/table/rack/shelf,
/obj/spawner/medical,
/obj/spawner/medical/low_chance,
/obj/spawner/medical_lowcost,
/turf/simulated/floor/tiled/derelict,
/area/crawler)
"z" = (
/obj/structure/table/rack/shelf,
/obj/spawner/medical,
/obj/spawner/medical_lowcost/low_chance,
/turf/simulated/floor/tiled/derelict,
/area/crawler)
"A" = (
/obj/structure/sign/department/toxin_res,
/turf/simulated/wall/untinted/onestar_reinforced,
/area/crawler)
"B" = (
/obj/structure/table/rack/shelf,
/obj/spawner/pack/tech_loot/low_chance,
/obj/spawner/oddities/low_chance,
/obj/spawner/tool/advanced/onestar/low_chance,
/turf/simulated/floor/tiled/derelict,
/area/crawler)
"C" = (
/obj/structure/table/onestar,
/obj/item/device/aicard,
/turf/simulated/floor/tiled/derelict,
/area/crawler)
"D" = (
/obj/item/phone,
/obj/structure/table/onestar,
/turf/simulated/floor/tiled/derelict,
/area/crawler)
"E" = (
/obj/structure/bed/chair/custom/onestar/red{
	icon_state = "onestar_chair_red";
	dir = 1
	},
/obj/item/remains/human,
/turf/simulated/floor/tiled/derelict,
/area/crawler)
"F" = (
/obj/machinery/light{
	icon_state = "tube1";
	dir = 1
	},
/turf/simulated/floor/tiled/derelict,
/area/crawler)
"G" = (
/obj/machinery/light/floor,
/turf/simulated/floor/tiled/derelict,
/area/crawler)
"H" = (
/obj/machinery/light,
/turf/simulated/floor/tiled/derelict,
/area/crawler)
"I" = (
/obj/structure/table/rack/shelf,
/obj/spawner/pack/tech_loot/low_chance,
/obj/spawner/pack/tech_loot/low_chance,
/obj/spawner/tool/advanced/onestar/low_chance,
/turf/simulated/floor/tiled/derelict,
/area/crawler)
"J" = (
/obj/structure/table/rack/shelf,
/obj/spawner/pack/tech_loot/low_chance,
/obj/spawner/tool/advanced/onestar/low_chance,
/turf/simulated/floor/tiled/derelict,
/area/crawler)
"K" = (
/obj/structure/table/rack/shelf,
/obj/spawner/pack/tech_loot/low_chance,
/obj/spawner/tool/advanced,
/turf/simulated/floor/tiled/derelict,
/area/crawler)
"L" = (
/obj/structure/table/rack/shelf,
/obj/spawner/pack/tech_loot/low_chance,
/obj/spawner/pack/gun_loot/low_chance,
/obj/spawner/tool/advanced/onestar/low_chance,
/turf/simulated/floor/tiled/derelict,
/area/crawler)
"M" = (
/obj/structure/table/rack/shelf,
/obj/spawner/pack/tech_loot/low_chance,
/obj/spawner/pack/gun_loot,
/obj/spawner/tool/advanced/onestar/low_chance,
/turf/simulated/floor/tiled/derelict,
/area/crawler)
"N" = (
/obj/structure/table/rack/shelf,
/obj/spawner/pack/gun_loot,
/obj/spawner/tool/advanced/onestar/low_chance,
/turf/simulated/floor/tiled/derelict,
/area/crawler)
"O" = (
/obj/structure/table/onestar,
/obj/effect/decal/cleanable/molten_item,
/obj/spawner/oddities/low_chance,
/obj/spawner/oddities/low_chance,
/turf/simulated/floor/tiled/derelict,
/area/crawler)
"P" = (
/obj/structure/table/onestar,
/obj/effect/decal/cleanable/molten_item,
/obj/machinery/light{
	icon_state = "tube1";
	dir = 1
	},
/obj/spawner/oddities/low_chance,
/obj/spawner/oddities/low_chance,
/turf/simulated/floor/tiled/derelict,
/area/crawler)
"Q" = (
/obj/structure/table/rack/shelf,
/obj/spawner/pack/gun_loot/low_chance,
/obj/spawner/oddities/low_chance,
/obj/spawner/tool/advanced,
/turf/simulated/floor/tiled/derelict,
/area/crawler)
"R" = (
/obj/structure/table/rack/shelf,
/obj/spawner/pack/gun_loot/low_chance,
/obj/spawner/tool/advanced,
/turf/simulated/floor/tiled/derelict,
/area/crawler)
"S" = (
/obj/structure/table/rack/shelf,
/obj/spawner/pack/tech_loot/low_chance,
/obj/spawner/pack/gun_loot/low_chance,
/obj/spawner/oddities/low_chance,
/obj/spawner/tool/advanced/onestar/low_chance,
/turf/simulated/floor/tiled/derelict,
/area/crawler)
"T" = (
/obj/structure/table/rack/shelf,
/obj/spawner/oddities,
/obj/spawner/oddities,
/obj/spawner/tool/advanced/onestar/low_chance,
/turf/simulated/floor/tiled/derelict,
/area/crawler)
"U" = (
/obj/structure/table/rack/shelf,
/obj/spawner/oddities/low_chance,
/obj/spawner/tool/advanced/onestar/low_chance,
/turf/simulated/floor/tiled/derelict,
/area/crawler)
"V" = (
/obj/structure/table/rack/shelf,
/obj/spawner/oddities/low_chance,
/obj/spawner/tool/advanced/onestar,
/turf/simulated/floor/tiled/derelict,
/area/crawler)
"W" = (
/obj/structure/table/rack/shelf,
/obj/spawner/tool/advanced/onestar,
/turf/simulated/floor/tiled/derelict,
/area/crawler)
"X" = (
/obj/map_data/crawler/bossfight,
/turf/unsimulated/wall,
/area/crawler)

(1,1,1) = {"
X
a
a
a
a
a
a
a
a
a
a
a
a
a
a
a
a
a
a
a
a
a
a
a
a
a
a
a
a
a
a
a
a
a
a
a
a
a
a
a
a
a
a
a
a
a
a
a
a
a
"}
(2,1,1) = {"
a
c
c
c
c
c
c
c
c
c
c
c
c
c
c
c
c
c
c
c
c
c
c
c
c
c
c
c
c
c
c
c
c
c
c
c
c
c
c
c
c
c
c
c
c
c
c
c
c
a
"}
(3,1,1) = {"
a
c
b
b
b
b
b
b
b
b
b
b
b
b
b
b
b
b
b
b
b
b
b
b
b
b
b
b
b
b
b
b
b
b
b
b
b
b
b
c
s
b
b
b
b
b
b
Q
c
a
"}
(4,1,1) = {"
a
c
b
b
b
b
b
b
b
b
b
b
b
b
b
b
b
b
b
b
b
b
b
b
b
b
b
b
b
b
b
b
b
b
b
b
b
G
b
c
B
b
t
b
b
v
b
R
c
a
"}
(5,1,1) = {"
a
c
b
G
b
b
b
b
b
b
b
b
b
b
b
b
b
b
b
b
b
b
b
b
b
b
G
b
b
b
b
b
b
G
b
b
b
b
b
c
I
b
b
b
b
b
b
R
c
a
"}
(6,1,1) = {"
a
c
b
b
b
b
b
b
b
b
b
b
b
b
b
b
G
b
b
b
b
b
G
b
b
b
b
b
b
b
b
b
b
b
b
b
b
b
b
c
J
b
b
b
b
b
b
S
c
a
"}
(7,1,1) = {"
a
c
b
b
b
b
b
b
b
b
b
b
b
b
b
b
b
b
b
b
b
b
b
b
b
b
b
b
b
b
b
b
b
b
b
b
b
b
b
c
K
b
b
b
b
b
b
L
c
a
"}
(8,1,1) = {"
a
c
b
b
b
b
b
b
b
b
b
b
b
b
b
b
b
b
b
b
b
b
b
b
b
b
b
b
b
b
b
b
b
b
b
b
b
b
H
c
F
b
b
b
b
b
b
H
c
a
"}
(9,1,1) = {"
a
c
b
b
b
b
b
b
b
b
b
b
G
b
b
b
b
b
b
b
b
b
b
b
b
b
b
b
G
b
b
b
b
b
b
b
b
b
b
d
b
b
b
b
b
b
b
b
c
a
"}
(10,1,1) = {"
a
c
b
b
b
b
b
b
b
b
b
b
b
b
b
b
b
b
b
b
b
b
b
b
b
b
b
b
b
b
b
b
b
b
b
b
b
b
H
c
F
b
b
b
b
b
b
b
c
a
"}
(11,1,1) = {"
a
c
b
b
b
b
b
b
b
b
b
b
b
b
b
b
b
b
b
b
b
b
c
c
c
b
b
b
b
b
b
b
b
b
b
b
b
b
b
c
b
b
b
b
b
b
b
H
c
a
"}
(12,1,1) = {"
a
c
b
b
b
b
b
b
b
b
b
b
b
b
b
b
b
b
G
b
b
b
b
b
b
b
b
b
b
b
b
b
b
b
b
b
b
b
b
c
L
b
b
b
b
b
b
T
c
a
"}
(13,1,1) = {"
a
c
c
c
c
c
c
b
b
b
b
b
b
b
b
b
b
b
b
b
b
b
b
b
b
b
b
b
b
b
b
b
b
b
b
b
b
b
b
c
M
b
b
b
b
b
b
U
c
a
"}
(14,1,1) = {"
a
c
l
b
b
q
c
b
b
b
b
b
b
b
b
b
b
b
b
b
b
b
b
b
G
b
b
b
b
b
b
b
b
b
b
G
b
b
b
c
N
b
b
b
b
b
b
V
c
a
"}
(15,1,1) = {"
a
c
h
b
b
x
c
b
b
b
b
b
b
b
b
b
b
b
b
b
b
b
b
b
b
b
b
b
b
b
b
c
b
b
b
b
b
b
b
c
N
b
u
b
b
w
b
W
c
a
"}
(16,1,1) = {"
a
c
b
b
b
b
c
b
b
b
b
b
b
b
b
b
b
b
b
b
b
b
b
b
b
b
b
b
b
b
b
c
F
b
b
b
b
b
b
c
N
b
b
b
b
b
b
W
c
a
"}
(17,1,1) = {"
a
c
F
b
b
H
c
b
c
c
b
b
b
b
b
b
c
b
b
b
b
b
b
b
b
b
b
b
b
b
b
c
b
b
b
b
b
b
b
c
c
c
c
c
c
c
c
c
c
a
"}
(18,1,1) = {"
a
c
b
b
b
b
c
b
b
b
b
b
b
b
b
b
b
b
b
b
b
b
b
b
b
b
b
b
b
b
b
b
b
b
b
b
b
b
b
b
b
b
c
O
b
b
b
b
c
a
"}
(19,1,1) = {"
a
c
m
b
b
y
c
b
b
b
b
b
G
b
b
b
b
b
b
b
b
b
b
b
b
b
b
b
b
b
b
b
b
b
b
b
b
b
b
b
b
b
c
C
b
b
b
b
c
a
"}
(20,1,1) = {"
a
c
n
b
b
y
c
b
b
b
b
b
b
b
b
b
b
b
b
G
b
b
b
b
b
b
b
b
b
b
b
b
b
b
b
b
b
b
b
b
b
H
c
P
b
b
b
b
c
a
"}
(21,1,1) = {"
a
c
o
b
b
z
c
b
b
b
b
b
b
b
b
b
b
b
b
b
b
b
b
b
b
G
b
b
b
b
b
b
b
b
b
b
b
b
b
b
b
b
d
b
b
G
b
b
c
a
"}
(22,1,1) = {"
a
c
c
d
c
c
c
b
b
b
b
b
b
b
b
b
b
b
b
b
b
b
b
b
b
b
b
b
b
b
b
b
b
b
b
b
b
G
b
b
b
H
A
F
b
b
b
b
c
a
"}
(23,1,1) = {"
a
c
f
b
i
k
c
b
b
b
b
b
b
b
G
b
b
b
b
b
b
b
b
b
b
b
b
b
b
b
b
b
b
b
c
b
b
b
b
b
b
b
c
b
b
b
b
b
c
a
"}
(24,1,1) = {"
a
c
g
b
b
H
A
b
b
b
b
b
b
b
b
b
b
b
b
b
b
b
b
b
b
b
b
b
b
b
b
b
b
b
b
b
b
b
b
b
b
b
c
D
E
b
b
b
c
a
"}
(25,1,1) = {"
a
c
F
b
e
b
d
b
b
b
b
b
b
b
b
b
b
b
b
b
b
b
b
b
b
r
b
b
b
b
b
b
b
b
b
b
b
b
b
b
b
b
c
c
c
c
c
c
c
a
"}
(26,1,1) = {"
a
c
g
b
b
H
A
b
b
b
b
b
b
b
b
b
b
b
b
b
b
b
b
b
b
b
b
b
b
b
b
b
b
b
b
b
b
b
b
b
b
b
b
b
b
b
b
b
c
a
"}
(27,1,1) = {"
a
c
h
b
j
j
c
b
b
b
b
b
b
b
b
b
b
b
b
b
b
b
b
b
b
b
b
b
b
b
b
b
b
b
b
b
b
G
b
b
b
b
b
b
b
b
b
b
c
a
"}
(28,1,1) = {"
a
c
c
c
c
c
c
b
b
b
b
b
b
b
b
b
b
b
G
b
b
b
b
b
b
b
b
b
b
b
b
b
b
b
b
b
b
b
b
b
b
b
b
b
b
b
b
b
c
a
"}
(29,1,1) = {"
a
c
b
b
b
b
b
b
b
b
G
b
b
b
c
b
b
b
b
b
b
b
b
b
b
b
b
b
b
b
b
b
b
b
b
b
b
b
b
b
b
b
b
b
b
b
b
b
c
a
"}
(30,1,1) = {"
a
c
b
b
b
b
b
b
b
b
b
b
b
b
b
b
b
b
b
b
b
b
b
b
b
b
b
b
b
b
b
G
b
b
b
b
b
b
b
b
b
b
b
b
b
b
b
b
c
a
"}
(31,1,1) = {"
a
c
b
b
b
b
b
b
b
b
b
b
b
b
b
b
b
b
b
b
b
b
b
b
b
b
b
b
b
b
b
b
b
b
b
b
b
b
b
b
b
b
b
b
G
b
b
b
c
a
"}
(32,1,1) = {"
a
c
b
b
b
b
b
b
b
b
b
b
b
b
b
b
b
b
b
b
b
b
b
b
G
b
b
b
b
b
b
b
b
b
b
b
b
b
b
b
b
b
b
b
b
b
b
b
c
a
"}
(33,1,1) = {"
a
c
b
b
b
b
b
b
b
b
b
b
b
b
b
b
b
b
b
b
b
b
b
b
b
b
b
b
b
b
b
b
b
b
b
b
b
b
b
b
b
b
b
b
b
b
b
b
c
a
"}
(34,1,1) = {"
a
c
b
b
G
b
b
b
b
b
c
b
b
b
b
b
c
b
b
b
b
b
b
b
b
b
b
b
b
b
b
b
b
b
b
b
b
b
b
c
b
b
b
b
b
b
b
b
c
a
"}
(35,1,1) = {"
a
c
b
b
b
b
b
b
b
b
c
b
b
b
b
b
b
b
b
b
b
G
b
b
b
b
b
b
b
b
b
b
b
b
b
b
b
b
b
b
b
b
b
b
b
b
b
b
c
a
"}
(36,1,1) = {"
a
c
b
b
b
b
b
b
b
b
c
b
b
b
b
b
b
b
b
b
b
b
b
b
b
b
b
b
b
b
b
c
c
c
b
b
G
b
b
b
b
b
b
b
b
b
b
b
c
a
"}
(37,1,1) = {"
a
c
b
b
b
b
b
b
b
b
b
b
b
G
b
b
b
b
b
b
b
b
b
b
b
b
b
b
b
b
b
b
b
b
b
b
b
b
b
b
b
b
b
b
b
b
b
b
c
a
"}
(38,1,1) = {"
a
c
b
b
b
b
b
b
b
b
b
b
b
b
b
b
b
b
b
b
b
b
b
b
b
c
b
b
b
b
b
b
b
b
b
b
b
b
b
b
b
b
b
b
b
b
b
b
c
a
"}
(39,1,1) = {"
a
c
b
b
b
b
b
b
b
b
b
b
b
b
b
b
b
b
b
b
b
b
b
b
b
c
b
b
b
b
b
b
b
b
b
b
b
b
b
c
b
b
b
b
b
b
b
b
c
a
"}
(40,1,1) = {"
a
c
b
b
b
b
b
b
b
b
b
b
b
b
b
b
b
b
b
b
b
b
b
b
b
c
b
b
b
b
b
b
b
b
b
b
b
b
b
c
b
b
b
b
G
b
b
b
c
a
"}
(41,1,1) = {"
a
c
b
b
b
b
b
b
b
b
b
b
b
b
b
b
b
b
b
b
b
b
b
b
b
b
b
b
b
b
b
b
b
b
b
b
b
b
b
c
b
b
b
b
b
b
b
b
c
a
"}
(42,1,1) = {"
a
c
b
b
b
G
b
b
b
G
b
b
b
b
c
c
c
b
b
b
G
b
b
b
b
b
b
b
b
b
b
b
b
b
b
b
b
b
b
b
b
b
b
b
b
b
b
b
c
a
"}
(43,1,1) = {"
a
c
b
b
b
b
b
b
b
b
b
b
b
b
b
b
b
b
b
b
b
b
b
b
b
b
b
b
b
b
b
b
b
b
b
b
b
b
b
b
b
b
b
b
b
b
b
b
c
a
"}
(44,1,1) = {"
a
c
b
b
b
b
b
b
b
b
b
b
b
b
b
b
b
b
b
b
b
b
b
b
b
b
b
b
b
b
b
G
b
b
b
b
b
b
b
b
b
b
b
b
b
b
b
b
c
a
"}
(45,1,1) = {"
a
c
b
b
b
b
b
b
b
b
b
b
b
b
b
b
b
b
b
b
b
b
b
b
b
b
b
b
b
b
b
b
b
b
b
b
b
b
b
b
b
b
b
b
b
b
b
b
c
a
"}
(46,1,1) = {"
a
c
b
b
b
b
b
b
b
b
b
b
b
b
b
b
b
b
b
b
b
b
b
b
b
b
b
b
b
b
b
b
b
b
b
b
b
b
b
b
b
b
b
b
b
b
b
b
c
a
"}
(47,1,1) = {"
a
c
b
b
b
b
b
b
b
b
b
b
b
b
b
b
b
b
b
b
b
b
b
b
b
b
b
b
b
b
b
b
b
b
b
b
b
b
b
b
b
b
b
b
b
b
b
b
c
a
"}
(48,1,1) = {"
a
c
G
b
b
b
b
b
b
b
b
b
b
b
b
b
b
b
b
b
b
b
b
b
b
b
b
b
b
b
b
b
b
b
b
b
b
b
b
b
b
b
b
b
b
b
b
G
c
a
"}
(49,1,1) = {"
a
c
c
c
c
c
c
c
c
c
c
c
c
c
c
c
c
c
c
c
c
c
c
c
c
c
c
c
c
c
c
c
c
c
c
c
c
c
c
c
c
c
c
c
c
c
c
c
c
a
"}
(50,1,1) = {"
a
a
a
a
a
a
a
a
a
a
a
a
a
a
a
a
a
a
a
a
a
a
a
a
a
a
a
a
a
a
a
a
a
a
a
a
a
a
a
a
a
a
a
a
a
a
a
a
a
a
"}
